          
 -------- 
 -      - 
 -  p   - 
 -      - 
 -  x   - 
 -  o   - 
 -      - 
 -------- 
          
